##########################
#.......#.......#######.##
#######.#.......#....##.##
#######.#............#...#
#.....#.#.......#....##.##
#.......#.......#######.##
#.....#.###.######......##
#######............#######
##########################
